date,hosp_First dose after 14 days,hosp_First dose within 14 days,hosp_Second dose after 14 days,hosp_Second dose within 14 days,hosp_Third dose after 14 days,hosp_Third dose within 14 days,hosp_Unvaccinated,icu_Second dose after 14 days,icu_Third dose after 14 days,icu_Third dose within 14 days,vax_dose 1,vax_dose 2,vax_dose 3,vax_dose 4,cum_sum_1,cum_sum_2,cum_sum_3,cum_sum_4
2021-01-01,0,1,0,0,0,0,730,0,0,0,1990,0,0,0,17198,0,0,0
2021-01-02,0,3,0,0,0,0,745,0,0,0,3238,0,0,0,20436,0,0,0
2021-01-03,1,3,0,0,0,0,748,0,0,0,3315,0,0,0,23751,0,0,0
2021-01-04,1,3,0,0,0,0,758,0,0,0,3466,4,0,0,27217,4,0,0
2021-01-05,1,2,0,0,0,0,736,0,0,0,4458,3,0,0,31675,7,0,0
2021-01-06,1,4,0,0,0,0,703,0,0,0,4559,170,0,0,36234,177,0,0
2021-01-07,1,4,0,0,0,0,675,0,0,0,3836,196,0,0,40070,373,0,0
2021-01-08,1,6,0,0,0,0,657,0,0,0,4193,386,0,0,44263,759,0,0
2021-01-09,1,7,0,0,0,0,633,0,0,0,2054,13,0,0,46317,772,0,0
2021-01-10,1,7,0,0,0,0,650,0,0,0,1934,5,0,0,48251,777,0,0
2021-01-11,1,11,0,0,0,0,654,0,0,0,5155,609,0,0,53406,1386,0,0
2021-01-12,1,10,0,0,0,0,644,0,0,0,4892,513,0,0,58298,1899,0,0
2021-01-13,1,10,0,0,0,0,622,0,0,0,7892,853,0,0,66190,2752,0,0
2021-01-14,2,10,0,0,0,0,627,0,0,0,6417,758,0,0,72607,3510,0,0
2021-01-15,2,9,0,0,0,0,607,0,0,0,7006,623,0,0,79613,4133,0,0
2021-01-16,2,12,0,0,0,0,582,0,0,0,4862,52,0,0,84475,4185,0,0
2021-01-17,3,16,0,0,0,0,579,0,0,0,3836,81,0,0,88311,4266,0,0
2021-01-18,4,17,0,0,0,0,582,0,0,0,1339,1025,0,0,89650,5291,0,0
2021-01-19,4,23,0,0,0,0,575,0,0,0,1867,1119,0,0,91517,6410,0,0
2021-01-20,5,27,0,0,0,0,549,0,0,0,458,1020,0,0,91975,7430,0,0
2021-01-21,5,27,0,0,0,0,523,0,0,0,276,1052,0,0,92251,8482,0,0
2021-01-22,5,23,0,0,0,0,506,0,0,0,193,982,0,0,92444,9464,0,0
2021-01-23,5,19,0,0,0,0,480,0,0,0,101,199,0,0,92545,9663,0,0
2021-01-24,5,20,0,0,0,0,463,0,0,0,40,413,0,0,92585,10076,0,0
2021-01-25,4,23,0,0,0,0,458,0,0,0,111,404,0,0,92696,10480,0,0
2021-01-26,5,23,0,0,0,0,438,0,0,0,200,1636,0,0,92896,12116,0,0
2021-01-27,5,28,0,0,0,0,422,0,0,0,202,1198,0,0,93098,13314,0,0
2021-01-28,6,30,0,0,0,0,417,0,0,0,252,2223,0,0,93350,15537,0,0
2021-01-29,6,30,0,0,0,0,410,0,0,0,235,966,0,0,93585,16503,0,0
2021-01-30,6,29,0,0,0,0,392,0,0,0,137,225,0,0,93722,16728,0,0
2021-01-31,8,31,0,0,0,0,381,0,0,0,78,78,0,0,93800,16806,0,0
2021-02-01,8,28,0,0,0,0,393,0,0,0,177,1177,0,0,93977,17983,0,0
2021-02-02,8,29,0,0,0,0,371,0,0,0,193,1701,0,0,94170,19684,0,0
2021-02-03,9,28,0,1,0,0,347,0,0,0,259,2866,0,0,94429,22550,0,0
2021-02-04,10,23,0,1,0,0,324,0,0,0,304,1528,0,0,94733,24078,0,0
2021-02-05,9,24,0,1,0,0,308,0,0,0,445,2341,0,0,95178,26419,0,0
2021-02-06,9,23,0,1,0,0,293,0,0,0,192,1567,0,0,95370,27986,0,0
2021-02-07,9,23,0,1,0,0,291,0,0,0,192,1950,0,0,95562,29936,0,0
2021-02-08,8,22,0,1,0,0,290,0,0,0,768,4667,0,0,96330,34603,0,0
2021-02-09,8,19,0,1,0,0,285,0,0,0,1451,4412,0,0,97781,39015,0,0
2021-02-10,8,18,0,1,0,0,266,0,0,0,1802,4854,0,0,99583,43869,0,0
2021-02-11,7,16,0,3,0,0,245,0,0,0,2033,3878,0,0,101616,47747,0,0
2021-02-12,6,16,0,4,0,0,232,0,0,0,850,3210,0,0,102466,50957,0,0
2021-02-13,5,16,0,3,0,0,235,0,0,0,129,1611,0,0,102595,52568,0,0
2021-02-14,5,15,0,3,0,0,234,0,0,0,92,1391,0,0,102687,53959,0,0
2021-02-15,6,15,0,3,0,0,248,0,0,0,341,1764,0,0,103028,55723,0,0
2021-02-16,5,17,0,3,0,0,246,0,0,0,781,2568,0,0,103809,58291,0,0
2021-02-17,6,16,0,2,0,0,242,0,0,0,2011,2008,0,0,105820,60299,0,0
2021-02-18,6,14,0,2,0,0,230,0,0,0,2669,3017,0,0,108489,63316,0,0
2021-02-19,6,14,1,1,0,0,220,0,0,0,3254,2498,0,0,111743,65814,0,0
2021-02-20,5,15,1,1,0,0,207,0,0,0,1858,2599,0,0,113601,68413,0,0
2021-02-21,4,15,1,1,0,0,221,0,0,0,1012,2975,0,0,114613,71388,0,0
2021-02-22,3,16,1,1,0,0,223,0,0,0,2736,4444,0,0,117349,75832,0,0
2021-02-23,2,15,1,1,0,0,206,0,0,0,2522,3777,0,0,119871,79609,0,0
2021-02-24,2,14,1,1,0,0,201,0,0,0,6067,3357,0,0,125938,82966,0,0
2021-02-25,2,13,1,1,0,0,202,0,0,0,9838,2499,0,0,135776,85465,0,0
2021-02-26,1,12,1,1,0,0,205,0,0,0,9484,2581,0,0,145260,88046,0,0
2021-02-27,1,11,1,1,0,0,197,0,0,0,7058,2343,0,0,152318,90389,0,0
2021-02-28,1,10,1,1,0,0,204,0,0,0,7467,556,0,0,159785,90945,0,0
2021-03-01,0,10,1,1,0,0,200,0,0,0,9313,624,0,0,169098,91569,0,0
2021-03-02,0,10,1,1,0,0,202,0,0,0,9980,832,0,0,179078,92401,0,0
2021-03-03,0,13,1,0,0,0,194,0,0,0,10638,1081,0,0,189716,93482,0,0
2021-03-04,0,11,1,0,0,0,203,0,0,0,9503,833,0,0,199219,94315,0,0
2021-03-05,0,11,1,0,0,0,205,0,0,0,9281,534,0,0,208500,94849,0,0
2021-03-06,0,13,1,0,0,0,196,0,0,0,8517,185,0,0,217017,95034,0,0
2021-03-07,0,15,1,0,0,0,205,0,0,0,5838,168,0,0,222855,95202,0,0
2021-03-08,0,16,1,0,0,0,210,0,0,0,7865,291,0,0,230720,95493,0,0
2021-03-09,0,19,0,0,0,0,196,0,0,0,8041,386,0,0,238761,95879,0,0
2021-03-10,0,19,0,0,0,0,201,0,0,0,10248,630,0,0,249009,96509,0,0
2021-03-11,1,18,0,0,0,0,203,0,0,0,12632,477,0,0,261641,96986,0,0
2021-03-12,1,18,0,0,0,0,202,0,0,0,13499,501,0,0,275140,97487,0,0
2021-03-13,3,19,0,0,0,0,194,0,0,0,10942,193,0,0,286082,97680,0,0
2021-03-14,5,17,0,0,0,0,200,0,0,0,9299,99,0,0,295381,97779,0,0
2021-03-15,5,21,0,0,0,0,195,0,0,0,18716,549,0,0,314097,98328,0,0
2021-03-16,7,22,0,0,0,0,194,0,0,0,19598,790,0,0,333695,99118,0,0
2021-03-17,6,22,0,0,0,0,199,0,0,0,22448,896,0,0,356143,100014,0,0
2021-03-18,5,23,0,0,0,0,200,0,0,0,22334,1128,0,0,378477,101142,0,0
2021-03-19,5,23,0,0,0,0,202,0,0,0,21572,356,0,0,400049,101498,0,0
2021-03-20,6,21,0,0,0,0,205,0,0,0,11155,134,0,0,411204,101632,0,0
2021-03-21,7,18,0,0,0,0,212,0,0,0,7093,117,0,0,418297,101749,0,0
2021-03-22,6,21,0,0,0,0,214,0,0,0,15304,395,0,0,433601,102144,0,0
2021-03-23,6,21,0,0,0,0,213,0,0,0,15446,745,0,0,449047,102889,0,0
2021-03-24,7,23,0,0,0,0,208,0,0,0,19141,825,0,0,468188,103714,0,0
2021-03-25,6,22,0,0,0,0,199,0,0,0,27532,842,0,0,495720,104556,0,0
2021-03-26,5,20,0,0,0,0,192,0,0,0,22644,761,0,0,518364,105317,0,0
2021-03-27,4,20,0,0,0,0,191,0,0,0,14102,1068,0,0,532466,106385,0,0
2021-03-28,5,21,0,0,0,0,200,0,0,0,10307,1144,0,0,542773,107529,0,0
2021-03-29,4,21,0,0,0,0,216,0,0,0,14646,2076,0,0,557419,109605,0,0
2021-03-30,3,18,0,0,0,0,211,0,0,0,18248,2209,0,0,575667,111814,0,0
2021-03-31,5,19,0,0,0,0,203,0,0,0,20478,2888,0,0,596145,114702,0,0
2021-04-01,7,20,0,0,0,0,201,0,0,0,24044,3985,0,0,620189,118687,0,0
2021-04-02,7,21,0,1,0,0,198,0,0,0,15213,1564,0,0,635402,120251,0,0
2021-04-03,9,21,0,1,0,0,197,0,0,0,12692,3312,0,0,648094,123563,0,0
2021-04-04,11,21,0,2,0,0,200,0,0,0,9429,4023,0,0,657523,127586,0,0
2021-04-05,13,24,0,2,0,0,207,0,0,0,11856,7317,0,0,669379,134903,0,0
2021-04-06,12,24,0,2,0,0,210,0,0,0,16601,10398,0,0,685980,145301,0,0
2021-04-07,11,24,1,2,0,0,216,0,0,0,20851,10433,0,0,706831,155734,0,0
2021-04-08,12,24,1,1,0,0,224,0,0,0,25254,10594,0,0,732085,166328,0,0
2021-04-09,17,27,1,2,0,0,232,0,0,0,27671,9932,0,0,759756,176260,0,0
2021-04-10,22,25,1,2,0,0,244,0,0,0,17170,7831,0,0,776926,184091,0,0
2021-04-11,21,31,1,2,0,0,250,0,0,0,11536,6648,0,0,788462,190739,0,0
2021-04-12,22,29,0,3,0,0,263,0,0,0,33216,8143,0,0,821678,198882,0,0
2021-04-13,20,30,0,5,0,0,275,0,0,0,25013,7709,0,0,846691,206591,0,0
2021-04-14,20,33,0,5,0,0,273,0,0,0,31762,9054,0,0,878453,215645,0,0
2021-04-15,21,34,1,5,0,0,273,0,0,0,31686,8343,0,0,910139,223988,0,0
2021-04-16,27,31,1,7,0,0,289,0,0,0,31807,9084,0,0,941946,233072,0,0
2021-04-17,29,31,1,7,0,0,284,0,0,0,18454,7457,0,0,960400,240529,0,0
2021-04-18,34,34,1,8,0,0,286,0,0,0,12720,5651,0,0,973120,246180,0,0
2021-04-19,39,36,1,8,0,0,302,0,0,0,26963,6187,0,0,1000083,252367,0,0
2021-04-20,41,36,2,8,0,0,309,0,0,0,35026,5588,0,0,1035109,257955,0,0
2021-04-21,38,35,1,7,0,0,331,0,0,0,37987,8411,0,0,1073096,266366,0,0
2021-04-22,39,40,1,8,0,0,343,0,0,0,40419,8319,0,0,1113515,274685,0,0
2021-04-23,48,43,1,9,0,0,361,0,0,0,37378,7086,0,0,1150893,281771,0,0
2021-04-24,52,46,1,9,0,0,355,0,0,0,26480,4367,0,0,1177373,286138,0,0
2021-04-25,50,50,3,8,0,0,376,0,0,0,17876,2722,0,0,1195249,288860,0,0
2021-04-26,52,48,3,9,0,0,387,0,0,0,26817,4883,0,0,1222066,293743,0,0
2021-04-27,56,50,5,9,0,0,389,0,0,0,25415,4965,0,0,1247481,298708,0,0
2021-04-28,50,46,5,9,0,0,375,0,0,0,28051,5347,0,0,1275532,304055,0,0
2021-04-29,50,57,5,8,0,0,383,0,0,0,33117,4196,0,0,1308649,308251,0,0
2021-04-30,46,55,5,7,0,0,385,0,0,0,32262,3390,0,0,1340911,311641,0,0
2021-05-01,51,57,6,5,0,0,383,0,0,0,24326,1855,0,0,1365237,313496,0,0
2021-05-02,55,52,7,4,0,0,390,0,0,0,18039,1103,0,0,1383276,314599,0,0
2021-05-03,52,54,8,4,0,0,415,0,0,0,25683,2366,0,0,1408959,316965,0,0
2021-05-04,48,49,9,4,0,0,414,0,0,0,24466,2635,0,0,1433425,319600,0,0
2021-05-05,51,57,10,5,0,0,398,0,0,0,36376,3385,0,0,1469801,322985,0,0
2021-05-06,50,54,12,4,0,0,390,0,0,0,58133,4065,0,0,1527934,327050,0,0
2021-05-07,54,53,11,5,0,0,394,0,0,0,52756,3162,0,0,1580690,330212,0,0
2021-05-08,56,53,10,5,0,0,389,0,0,0,42450,1961,0,0,1623140,332173,0,0
2021-05-09,57,54,10,5,0,0,411,0,0,0,24624,1152,0,0,1647764,333325,0,0
2021-05-10,51,61,10,6,0,0,419,0,0,0,31208,1188,0,0,1678972,334513,0,0
2021-05-11,52,64,8,4,0,0,437,0,0,0,29816,1831,0,0,1708788,336344,0,0
2021-05-12,49,64,7,4,0,0,425,1,0,0,45507,2181,0,0,1754295,338525,0,0
2021-05-13,54,59,7,4,0,0,418,1,0,0,65512,3028,0,0,1819807,341553,0,0
2021-05-14,54,54,8,5,0,0,394,2,0,0,56930,2243,0,0,1876737,343796,0,0
2021-05-15,52,53,8,5,0,0,365,2,0,0,46044,1639,0,0,1922781,345435,0,0
2021-05-16,54,53,11,5,0,0,373,1,0,0,27094,893,0,0,1949875,346328,0,0
2021-05-17,53,53,11,5,0,0,387,1,0,0,24482,1378,0,0,1974357,347706,0,0
2021-05-18,55,55,13,5,0,0,373,1,0,0,29532,2618,0,0,2003889,350324,0,0
2021-05-19,64,55,12,6,0,0,361,1,0,0,44404,4451,0,0,2048293,354775,0,0
2021-05-20,61,46,11,7,0,0,348,1,0,0,76277,5754,0,0,2124570,360529,0,0
2021-05-21,57,42,11,8,0,0,340,0,0,0,54024,5164,0,0,2178594,365693,0,0
2021-05-22,54,38,12,8,0,0,317,0,0,0,41728,4890,0,0,2220322,370583,0,0
2021-05-23,52,41,11,7,0,0,306,0,0,0,22863,1892,0,0,2243185,372475,0,0
2021-05-24,52,41,14,7,0,0,298,0,0,0,17073,1207,0,0,2260258,373682,0,0
2021-05-25,54,41,16,7,0,0,274,0,0,0,23588,3883,0,0,2283846,377565,0,0
2021-05-26,52,47,13,6,0,0,269,0,0,0,34345,6745,0,0,2318191,384310,0,0
2021-05-27,50,43,12,6,0,0,258,0,0,0,45554,9438,0,0,2363745,393748,0,0
2021-05-28,39,41,9,6,0,0,246,1,0,0,40594,9388,0,0,2404339,403136,0,0
2021-05-29,38,34,10,6,0,0,223,1,0,0,32211,7668,0,0,2436550,410804,0,0
2021-05-30,39,32,11,5,0,0,224,1,0,0,18805,2941,0,0,2455355,413745,0,0
2021-05-31,40,29,12,5,0,0,229,1,0,0,23295,6376,0,0,2478650,420121,0,0
2021-06-01,41,33,11,5,0,0,228,1,0,0,18407,8250,0,0,2497057,428371,0,0
2021-06-02,42,29,11,5,0,0,205,1,0,0,24037,24177,0,0,2521094,452548,0,0
2021-06-03,40,26,11,4,0,0,189,1,0,0,27726,38679,0,0,2548820,491227,0,0
2021-06-04,36,24,13,4,0,0,191,1,0,0,23918,36668,0,0,2572738,527895,0,0
2021-06-05,38,24,14,4,0,0,188,1,0,0,18701,27310,0,0,2591439,555205,0,0
2021-06-06,37,25,15,4,0,0,179,1,0,0,10854,16834,0,0,2602293,572039,0,0
2021-06-07,35,22,15,3,0,0,180,1,0,0,10395,27645,0,0,2612688,599684,0,0
2021-06-08,35,21,16,3,0,0,176,1,0,0,8998,25853,0,0,2621686,625537,0,0
2021-06-09,29,18,17,3,0,0,163,1,0,0,11473,33822,0,0,2633159,659359,0,0
2021-06-10,29,17,16,3,0,0,157,1,0,0,13703,45135,0,0,2646862,704494,0,0
2021-06-11,31,15,15,3,0,0,155,1,0,0,11352,51260,0,0,2658214,755754,0,0
2021-06-12,32,14,14,2,0,0,138,1,0,0,8891,40232,0,0,2667105,795986,0,0
2021-06-13,36,15,14,2,0,0,135,1,0,0,3892,25066,0,0,2670997,821052,0,0
2021-06-14,36,15,13,2,0,0,142,0,0,0,4818,43896,0,0,2675815,864948,0,0
2021-06-15,38,13,13,2,0,0,129,0,0,0,5087,41854,0,0,2680902,906802,0,0
2021-06-16,39,13,14,2,0,0,120,0,0,0,6326,48002,0,0,2687228,954804,0,0
2021-06-17,38,11,15,2,0,0,119,0,0,0,9471,61642,0,0,2696699,1016446,0,0
2021-06-18,32,11,16,3,0,0,117,0,0,0,8639,60205,0,0,2705338,1076651,0,0
2021-06-19,29,12,16,3,0,0,106,0,0,0,7215,48399,0,0,2712553,1125050,0,0
2021-06-20,31,10,16,3,0,0,103,1,0,0,3002,24873,0,0,2715555,1149923,0,0
2021-06-21,28,11,15,3,0,0,96,1,0,0,4736,44382,0,0,2720291,1194305,0,0
2021-06-22,28,11,14,2,0,0,94,1,0,0,5157,50607,0,0,2725448,1244912,0,0
2021-06-23,28,10,14,1,0,0,92,1,0,0,4966,50960,0,0,2730414,1295872,0,0
2021-06-24,25,9,13,1,0,0,91,1,0,0,5368,51721,0,0,2735782,1347593,0,0
2021-06-25,23,10,12,2,0,0,92,1,0,0,5764,68995,0,0,2741546,1416588,0,0
2021-06-26,22,12,12,2,0,0,87,1,0,0,5281,60677,0,0,2746827,1477265,0,0
2021-06-27,21,13,13,3,0,0,92,1,0,0,3081,40413,0,0,2749908,1517678,0,0
2021-06-28,20,13,12,3,0,0,87,1,0,0,4727,63867,0,0,2754635,1581545,0,0
2021-06-29,21,12,12,3,0,0,82,1,0,0,4940,62108,0,0,2759575,1643653,0,0
2021-06-30,19,10,11,2,0,0,76,2,0,0,5261,59926,0,0,2764836,1703579,0,0
2021-07-01,16,10,11,2,0,0,71,2,0,0,2046,29232,0,0,2766882,1732811,0,0
2021-07-02,16,9,11,1,0,0,71,1,0,0,4539,55842,0,0,2771421,1788653,0,0
2021-07-03,16,9,10,1,0,0,69,1,0,0,3764,50573,0,0,2775185,1839226,0,0
2021-07-04,16,8,9,0,0,0,68,1,0,0,1952,28836,0,0,2777137,1868062,0,0
2021-07-05,18,7,9,0,0,0,70,1,0,0,4000,47533,0,0,2781137,1915595,0,0
2021-07-06,19,7,9,0,0,0,73,1,0,0,4158,48875,0,0,2785295,1964470,0,0
2021-07-07,18,5,9,0,0,0,65,1,0,0,4477,43162,0,0,2789772,2007632,0,0
2021-07-08,17,4,9,0,0,0,59,1,0,0,4438,41372,0,0,2794210,2049004,0,0
2021-07-09,14,4,8,0,0,0,54,1,0,0,4121,39192,0,0,2798331,2088196,0,0
2021-07-10,16,4,9,0,0,0,53,1,0,0,3057,28973,0,0,2801388,2117169,0,0
2021-07-11,13,4,9,0,0,0,49,1,0,0,1990,13905,0,0,2803378,2131074,0,0
2021-07-12,13,4,9,0,0,0,50,1,0,0,3276,23438,0,0,2806654,2154512,0,0
2021-07-13,13,3,9,0,0,0,51,1,0,0,3032,20300,0,0,2809686,2174812,0,0
2021-07-14,13,3,9,1,0,0,47,1,0,0,3045,24097,0,0,2812731,2198909,0,0
2021-07-15,14,3,8,1,0,0,53,1,0,0,3612,29740,0,0,2816343,2228649,0,0
2021-07-16,12,3,8,1,0,0,53,1,0,0,3851,29061,0,0,2820194,2257710,0,0
2021-07-17,11,3,9,1,0,0,51,1,0,0,2919,24642,0,0,2823113,2282352,0,0
2021-07-18,10,3,9,0,0,0,51,1,0,0,1615,13979,0,0,2824728,2296331,0,0
2021-07-19,11,3,9,1,0,0,46,1,0,0,2914,19529,0,0,2827642,2315860,0,0
2021-07-20,12,3,10,1,0,0,42,1,0,0,2709,18012,0,0,2830351,2333872,0,0
2021-07-21,12,2,9,1,0,0,41,1,0,0,3376,24912,0,0,2833727,2358784,0,0
2021-07-22,11,2,9,1,0,0,35,1,0,0,3755,25200,0,0,2837482,2383984,0,0
2021-07-23,10,2,10,1,0,0,39,1,0,0,3883,26196,0,0,2841365,2410180,0,0
2021-07-24,9,2,9,1,0,0,38,1,0,0,3004,18740,0,0,2844369,2428920,0,0
2021-07-25,9,2,9,1,0,0,40,1,0,0,1571,10667,0,0,2845940,2439587,0,0
2021-07-26,9,2,8,2,0,0,42,1,0,0,3132,16922,0,0,2849072,2456509,0,0
2021-07-27,9,2,8,1,0,0,47,1,0,0,3196,15087,0,0,2852268,2471596,0,0
2021-07-28,9,2,8,1,0,0,49,1,0,0,3410,14346,0,0,2855678,2485942,0,0
2021-07-29,9,2,9,1,0,0,50,1,0,0,3515,13809,0,0,2859193,2499751,0,0
2021-07-30,8,2,9,1,0,0,55,1,0,0,3538,13754,0,0,2862731,2513505,0,0
2021-07-31,8,2,9,1,0,0,55,1,0,0,2291,8603,0,0,2865022,2522108,0,0
2021-08-01,8,1,8,1,0,0,54,2,0,0,1270,3998,14,0,2866292,2526106,14,0
2021-08-02,8,1,8,2,0,0,49,2,0,0,1349,3642,11,0,2867641,2529748,25,0
2021-08-03,8,1,9,3,0,0,54,2,0,0,3062,8839,26,0,2870703,2538587,51,0
2021-08-04,9,1,12,2,0,0,55,2,0,0,2878,8003,33,0,2873581,2546590,84,0
2021-08-05,9,1,11,0,0,0,65,3,0,0,2643,8007,41,0,2876224,2554597,125,0
2021-08-06,10,1,11,2,0,0,68,2,0,0,2727,8508,57,0,2878951,2563105,182,0
2021-08-07,11,1,15,3,0,0,63,2,0,0,2029,6571,27,0,2880980,2569676,209,0
2021-08-08,13,1,17,3,0,0,69,3,0,0,1166,3419,10,0,2882146,2573095,219,0
2021-08-09,14,1,17,1,0,0,74,3,0,0,2370,6154,26,0,2884516,2579249,245,0
2021-08-10,13,2,19,1,0,0,76,2,0,0,2435,5646,42,0,2886951,2584895,287,0
2021-08-11,9,1,24,1,0,0,85,2,0,0,2465,5934,39,0,2889416,2590829,326,0
2021-08-12,10,1,24,1,0,0,85,2,0,0,2537,6009,37,0,2891953,2596838,363,0
2021-08-13,9,1,25,1,0,0,87,2,0,0,2950,6883,59,0,2894903,2603721,422,0
2021-08-14,7,1,22,1,0,0,83,2,0,0,2053,4774,29,0,2896956,2608495,451,0
2021-08-15,8,1,22,1,0,0,97,2,0,0,1141,2567,12,0,2898097,2611062,463,0
2021-08-16,9,1,24,1,0,0,106,3,0,0,2745,5506,26,0,2900842,2616568,489,0
2021-08-17,10,1,31,1,0,0,102,3,0,0,2569,4967,37,0,2903411,2621535,526,0
2021-08-18,11,2,32,1,0,0,119,2,0,0,2736,5185,46,0,2906147,2626720,572,0
2021-08-19,11,2,36,1,0,0,134,2,0,0,2834,5148,60,0,2908981,2631868,632,0
2021-08-20,10,2,33,1,0,0,155,2,0,0,3066,6219,48,0,2912047,2638087,680,0
2021-08-21,9,2,36,0,0,0,148,2,0,0,1974,4187,35,0,2914021,2642274,715,0
2021-08-22,11,2,41,0,0,0,149,2,0,0,1051,2137,22,0,2915072,2644411,737,0
2021-08-23,11,2,45,0,0,0,159,2,0,0,2797,4917,48,0,2917869,2649328,785,0
2021-08-24,11,4,54,0,0,0,174,1,0,0,3167,4909,53,0,2921036,2654237,838,0
2021-08-25,10,5,58,1,0,0,183,1,0,0,3566,5048,57,0,2924602,2659285,895,0
2021-08-26,10,5,67,0,0,0,192,2,0,0,3605,5267,52,0,2928207,2664552,947,0
2021-08-27,9,5,71,0,0,0,202,3,0,0,3845,5892,61,0,2932052,2670444,1008,0
2021-08-28,8,5,78,0,0,0,219,4,0,0,2395,4245,26,0,2934447,2674689,1034,0
2021-08-29,12,6,73,1,0,0,233,7,0,0,1288,2152,11,0,2935735,2676841,1045,0
2021-08-30,12,5,80,2,0,0,250,8,0,0,2970,4321,88,0,2938705,2681162,1133,0
2021-08-31,13,5,85,1,0,0,282,9,0,0,2909,4129,493,0,2941614,2685291,1626,0
2021-09-01,13,7,90,1,0,0,288,11,0,0,3845,4518,5784,0,2945459,2689809,7410,0
2021-09-02,17,8,102,1,0,0,307,11,0,0,4274,4914,5713,0,2949733,2694723,13123,0
2021-09-03,19,10,110,0,0,0,313,12,0,1,4873,6275,5861,0,2954606,2700998,18984,0
2021-09-04,20,11,114,1,0,0,317,13,0,1,3638,4443,2784,0,2958244,2705441,21768,0
2021-09-05,19,11,120,1,0,0,323,13,0,1,1968,2310,1015,0,2960212,2707751,22783,0
2021-09-06,26,11,127,1,0,0,334,13,0,1,1805,2105,1045,0,2962017,2709856,23828,0
2021-09-07,31,14,137,2,0,0,356,14,0,1,4084,3708,5150,0,2966101,2713564,28978,0
2021-09-08,33,15,146,2,0,0,357,13,0,1,3985,3471,5100,0,2970086,2717035,34078,0
2021-09-09,32,14,154,3,0,1,348,14,0,1,4323,3845,5702,1,2974409,2720880,39780,1
2021-09-10,32,16,158,2,0,0,380,16,0,1,5359,5597,7168,0,2979768,2726477,46948,1
2021-09-11,32,16,159,3,0,0,391,16,0,1,3547,3902,3032,0,2983315,2730379,49980,1
2021-09-12,28,20,167,3,0,0,416,18,0,1,1654,1703,1350,0,2984969,2732082,51330,1
2021-09-13,28,18,174,4,0,0,415,18,0,1,4762,4300,6119,0,2989731,2736382,57449,1
2021-09-14,28,20,187,4,0,3,440,16,0,1,4911,4166,6113,1,2994642,2740548,63562,2
2021-09-15,32,18,193,4,0,4,452,16,0,1,6136,4960,6468,0,3000778,2745508,70030,2
2021-09-16,28,19,200,3,0,3,471,14,0,1,17019,9196,6906,4,3017797,2754704,76936,6
2021-09-17,26,17,196,3,1,3,490,16,0,1,17479,10291,6655,0,3035276,2764995,83591,6
2021-09-18,30,19,184,3,1,5,515,18,0,1,11628,6717,2846,0,3046904,2771712,86437,6
2021-09-19,28,19,197,4,1,6,513,18,0,1,6328,3489,1127,0,3053232,2775201,87564,6
2021-09-20,30,19,201,4,1,6,541,15,0,1,14640,7554,5117,1,3067872,2782755,92681,7
2021-09-21,30,18,205,3,2,5,567,17,0,2,11359,6140,5059,2,3079231,2788895,97740,9
2021-09-22,28,19,206,4,2,5,586,17,0,2,11008,6411,5800,8,3090239,2795306,103540,17
2021-09-23,27,26,204,4,2,8,582,18,0,3,11259,6722,5074,8,3101498,2802028,108614,25
2021-09-24,33,26,202,5,2,7,575,19,0,4,12030,7995,5593,6,3113528,2810023,114207,31
2021-09-25,34,28,193,6,1,8,548,19,0,4,7391,5177,2002,2,3120919,2815200,116209,33
2021-09-26,33,32,203,6,1,8,555,18,0,4,3524,2497,907,3,3124443,2817697,117116,36
2021-09-27,37,35,212,7,1,10,577,19,0,4,7887,4857,3989,7,3132330,2822554,121105,43
2021-09-28,34,35,209,6,1,11,549,20,0,4,7543,4921,4228,19,3139873,2827475,125333,62
2021-09-29,35,33,211,6,2,10,552,19,0,3,7753,5632,4035,71,3147626,2833107,129368,133
2021-09-30,35,33,206,6,2,10,539,21,0,3,6924,5428,4102,95,3154550,2838535,133470,228
2021-10-01,33,36,208,6,2,11,534,22,0,3,7400,6687,3458,131,3161950,2845222,136928,359
2021-10-02,34,32,205,7,4,15,562,21,0,3,4450,4428,1517,79,3166400,2849650,138445,438
2021-10-03,33,39,207,9,4,18,540,22,0,2,2343,2177,592,31,3168743,2851827,139037,469
2021-10-04,35,37,214,9,5,18,553,18,0,2,5373,4598,2789,105,3174116,2856425,141826,574
2021-10-05,34,44,220,9,6,16,545,19,0,2,4824,4298,2858,112,3178940,2860723,144684,686
2021-10-06,36,44,200,11,6,19,552,21,0,2,5469,4838,7221,120,3184409,2865561,151905,806
2021-10-07,34,40,211,11,7,15,542,20,0,3,5604,5702,6737,99,3190013,2871263,158642,905
2021-10-08,38,37,199,11,7,16,523,18,0,3,6299,7910,6791,142,3196312,2879173,165433,1047
2021-10-09,33,34,194,11,6,14,512,17,0,3,3647,5005,2896,62,3199959,2884178,168329,1109
2021-10-10,39,28,203,12,6,16,526,19,0,3,1809,2607,1183,18,3201768,2886785,169512,1127
2021-10-11,40,29,197,11,6,16,534,17,0,3,1535,2222,1400,33,3203303,2889007,170912,1160
2021-10-12,41,36,200,10,7,14,516,18,0,3,5296,7820,7332,144,3208599,2896827,178244,1304
2021-10-13,38,37,201,12,7,13,498,19,0,2,5582,8130,7138,146,3214181,2904957,185382,1450
2021-10-14,44,40,197,15,6,10,479,22,0,3,5677,9271,7220,129,3219858,2914228,192602,1579
2021-10-15,44,41,197,15,6,10,472,23,0,2,4104,11713,7417,160,3223962,2925941,200019,1739
2021-10-16,44,40,196,14,6,10,464,18,0,1,2619,7479,3227,77,3226581,2933420,203246,1816
2021-10-17,43,39,196,14,5,9,465,20,0,1,1425,4147,1462,39,3228006,2937567,204708,1855
2021-10-18,41,36,198,14,4,9,463,20,0,1,3238,8746,6247,113,3231244,2946313,210955,1968
2021-10-19,38,31,203,13,4,10,440,19,0,1,2868,7262,5597,94,3234112,2953575,216552,2062
2021-10-20,39,27,199,11,3,10,429,19,0,1,2884,7906,5507,104,3236996,2961481,222059,2166
2021-10-21,39,26,194,13,3,9,425,21,0,1,2963,8517,6251,80,3239959,2969998,228310,2246
2021-10-22,35,21,179,11,4,9,419,24,0,1,3272,10712,6001,101,3243231,2980710,234311,2347
2021-10-23,31,20,175,12,3,10,394,23,0,1,2281,7054,2436,59,3245512,2987764,236747,2406
2021-10-24,32,21,177,11,3,9,402,23,0,1,1241,3932,1119,19,3246753,2991696,237866,2425
2021-10-25,33,27,170,11,4,11,413,23,0,1,2568,9227,4977,77,3249321,3000923,242843,2502
2021-10-26,25,25,173,10,4,10,397,22,0,1,2543,7620,4837,66,3251864,3008543,247680,2568
2021-10-27,27,22,159,9,3,10,387,24,0,1,2469,7268,4650,73,3254333,3015811,252330,2641
2021-10-28,29,21,157,9,3,11,375,22,0,1,2602,7490,4745,70,3256935,3023301,257075,2711
2021-10-29,28,20,151,9,3,9,365,18,0,1,2721,9155,4218,90,3259656,3032456,261293,2801
2021-10-30,26,17,142,9,3,8,349,16,0,1,1772,5559,1943,57,3261428,3038015,263236,2858
2021-10-31,22,16,143,8,3,8,349,16,0,1,846,2594,641,25,3262274,3040609,263877,2883
2021-11-01,23,18,136,9,3,8,352,16,0,1,2372,6016,3459,61,3264646,3046625,267336,2944
2021-11-02,22,16,140,10,2,7,362,14,0,1,2170,5328,3156,41,3266816,3051953,270492,2985
2021-11-03,23,15,140,10,2,7,352,13,1,1,2076,5248,3293,52,3268892,3057201,273785,3037
2021-11-04,23,15,137,10,3,9,335,13,1,1,1971,5418,4253,53,3270863,3062619,278038,3090
2021-11-05,23,12,135,8,3,9,342,14,1,1,2438,7099,4085,67,3273301,3069718,282123,3157
2021-11-06,20,15,127,7,3,9,323,16,1,1,1528,4431,1797,42,3274829,3074149,283920,3199
2021-11-07,20,14,125,7,2,9,309,15,1,1,844,2312,850,16,3275673,3076461,284770,3215
2021-11-08,18,13,125,7,3,9,317,15,1,1,2041,4719,9067,48,3277714,3081180,293837,3263
2021-11-09,22,11,121,7,5,7,301,15,1,1,1934,4397,7604,33,3279648,3085577,301441,3296
2021-11-10,25,11,112,5,6,7,299,13,1,1,2264,5808,8172,49,3281912,3091385,309613,3345
2021-11-11,22,11,109,6,6,8,294,14,1,1,1076,2761,2685,10,3282988,3094146,312298,3355
2021-11-12,19,11,107,7,7,8,289,15,1,1,2378,7171,6576,53,3285366,3101317,318874,3408
2021-11-13,19,10,106,7,8,8,279,15,1,1,1414,4007,2981,32,3286780,3105324,321855,3440
2021-11-14,19,10,106,7,7,7,273,15,2,1,1033,2219,1223,9,3287813,3107543,323078,3449
2021-11-15,19,10,112,7,7,7,271,13,2,1,2117,5489,5129,52,3289930,3113032,328207,3501
2021-11-16,18,10,108,7,6,7,273,11,2,1,1770,3859,3661,21,3291700,3116891,331868,3522
2021-11-17,18,10,106,8,7,7,268,11,2,1,2047,4058,4491,33,3293747,3120949,336359,3555
2021-11-18,17,9,102,8,6,7,265,11,3,1,1831,3902,4204,34,3295578,3124851,340563,3589
2021-11-19,17,8,103,7,5,5,256,11,3,1,2151,4942,4695,31,3297729,3129793,345258,3620
2021-11-20,16,8,101,6,6,5,243,10,3,1,1582,3107,2010,26,3299311,3132900,347268,3646
2021-11-21,16,8,100,6,6,5,244,9,3,1,930,1671,984,10,3300241,3134571,348252,3656
2021-11-22,14,8,104,6,6,6,255,8,3,0,1785,3819,3599,25,3302026,3138390,351851,3681
2021-11-23,12,9,106,6,8,6,244,11,2,0,1822,3387,3206,22,3303848,3141777,355057,3703
2021-11-24,12,8,103,5,8,6,240,11,2,0,1684,3114,3442,22,3305532,3144891,358499,3725
2021-11-25,12,8,103,6,11,6,244,11,2,0,1850,3209,3577,23,3307382,3148100,362076,3748
2021-11-26,13,9,101,6,12,5,245,10,2,0,7997,3710,3997,29,3315379,3151810,366073,3777
2021-11-27,13,7,98,6,13,5,237,9,2,0,7483,2576,2217,23,3322862,3154386,368290,3800
2021-11-28,14,6,95,6,13,5,233,10,2,0,6425,1381,1109,6,3329287,3155767,369399,3806
2021-11-29,14,6,92,6,15,5,236,10,2,0,9957,3050,4719,28,3339244,3158817,374118,3834
2021-11-30,14,6,90,6,17,5,219,11,1,0,8311,2842,5197,42,3347555,3161659,379315,3876
2021-12-01,12,6,93,6,16,5,218,12,1,0,8222,2683,5838,41,3355777,3164342,385153,3917
2021-12-02,12,6,91,5,14,5,201,12,1,0,7773,2388,10270,42,3363550,3166730,395423,3959
2021-12-03,12,7,91,5,13,4,198,13,1,0,7873,2912,12991,55,3371423,3169642,408414,4014
2021-12-04,10,6,95,5,14,4,183,12,2,0,7632,1917,7550,22,3379055,3171559,415964,4036
2021-12-05,8,6,96,6,14,4,185,14,2,0,4990,1039,3321,11,3384045,3172598,419285,4047
2021-12-06,10,6,93,6,15,4,189,14,2,0,5640,2128,20388,42,3389685,3174726,439673,4089
2021-12-07,10,6,89,6,16,3,192,15,0,0,5143,1956,15557,35,3394828,3176682,455230,4124
2021-12-08,10,7,86,5,18,3,185,15,0,0,4508,1999,13460,36,3399336,3178681,468690,4160
2021-12-09,10,5,88,4,20,2,184,16,0,0,4413,1845,15291,33,3403749,3180526,483981,4193
2021-12-10,11,5,91,4,22,2,187,16,1,0,5932,2346,17629,46,3409681,3182872,501610,4239
2021-12-11,11,4,84,3,20,2,184,15,1,0,5287,1616,10028,39,3414968,3184488,511638,4278
2021-12-12,11,4,87,3,21,2,175,15,1,0,3316,891,4740,9,3418284,3185379,516378,4287
2021-12-13,10,4,89,3,21,2,184,15,1,0,3221,2004,17882,35,3421505,3187383,534260,4322
2021-12-14,11,4,89,3,21,2,176,16,1,0,2695,1694,15954,33,3424200,3189077,550214,4355
2021-12-15,10,5,89,3,20,2,170,15,1,0,2812,1817,23511,48,3427012,3190894,573725,4403
2021-12-16,10,5,87,4,19,2,163,11,1,1,2520,1664,24101,41,3429532,3192558,597826,4444
2021-12-17,9,5,82,3,20,3,159,9,1,1,4466,1946,28331,61,3433998,3194504,626157,4505
2021-12-18,9,4,75,3,15,3,151,10,1,1,4248,1391,18667,36,3438246,3195895,644824,4541
2021-12-19,9,5,85,3,16,4,147,9,1,1,2963,799,8423,19,3441209,3196694,653247,4560
2021-12-20,9,5,90,3,17,4,147,8,2,1,4179,1805,26799,67,3445388,3198499,680046,4627
2021-12-21,9,4,91,3,18,5,145,8,2,1,3531,1646,39844,70,3448919,3200145,719890,4697
2021-12-22,7,2,96,2,17,4,142,8,3,1,3063,1439,48952,71,3451982,3201584,768842,4768
2021-12-23,6,2,89,2,19,4,153,9,3,1,2341,1325,38564,65,3454323,3202909,807406,4833
2021-12-24,6,2,89,2,18,4,147,8,3,1,1210,731,20180,33,3455533,3203640,827586,4866
2021-12-25,7,2,89,2,23,3,142,6,2,1,25,40,1356,1,3455558,3203680,828942,4867
2021-12-26,8,2,88,2,26,3,145,6,2,1,775,273,7429,5,3456333,3203953,836371,4872
2021-12-27,8,2,91,2,34,3,154,6,2,1,2324,1094,28290,41,3458657,3205047,864661,4913
2021-12-28,14,2,102,2,37,4,164,7,1,1,2453,1170,29925,35,3461110,3206217,894586,4948
2021-12-29,14,3,119,2,42,4,161,7,1,1,2733,1192,31378,33,3463843,3207409,925964,4981
2021-12-30,14,3,133,4,47,4,167,6,1,1,2219,1101,28886,42,3466062,3208510,954850,5023
2021-12-31,10,4,135,4,52,3,164,5,2,1,1494,808,19861,35,3467556,3209318,974711,5058
2022-01-01,10,4,143,4,54,4,163,7,2,1,492,211,7876,11,3468048,3209529,982587,5069
2022-01-02,13,4,148,3,59,5,176,6,2,2,1278,572,11439,11,3469326,3210101,994026,5080
2022-01-03,14,2,155,3,68,7,178,8,1,2,2004,1206,24365,38,3471330,3211307,1018391,5118
2022-01-04,13,3,186,3,78,9,186,8,3,1,2163,1211,23802,45,3473493,3212518,1042193,5163
2022-01-05,15,3,197,3,91,14,177,10,3,1,2601,1343,24964,43,3476094,3213861,1067157,5206
2022-01-06,18,3,212,4,97,16,183,10,4,1,2558,1614,26894,45,3478652,3215475,1094051,5251
2022-01-07,23,3,233,3,112,15,206,14,3,1,2585,1777,31875,71,3481237,3217252,1125926,5322
2022-01-08,28,3,236,3,120,14,207,15,3,2,2233,1297,22322,28,3483470,3218549,1148248,5350
2022-01-09,31,3,253,4,126,18,222,17,3,1,1583,905,11422,17,3485053,3219454,1159670,5367
2022-01-10,33,5,285,4,142,19,224,18,6,1,2376,1687,22266,57,3487429,3221141,1181936,5424
2022-01-11,32,5,304,3,143,21,236,15,8,1,2294,1675,21273,60,3489723,3222816,1203209,5484
2022-01-12,33,6,323,2,154,21,247,16,6,0,2646,1895,21535,44,3492369,3224711,1224744,5528
2022-01-13,32,6,341,3,173,28,253,19,6,0,2567,1877,20772,78,3494936,3226588,1245516,5606
2022-01-14,33,5,357,3,185,33,275,21,9,0,2717,1870,24085,79,3497653,3228458,1269601,5685
2022-01-15,31,5,362,4,200,33,273,22,10,2,2669,1798,18203,48,3500322,3230256,1287804,5733
2022-01-16,38,7,382,6,218,37,291,25,9,3,1605,1278,8055,24,3501927,3231534,1295859,5757
2022-01-17,45,8,412,5,233,47,310,28,12,3,2015,1619,14719,37,3503942,3233153,1310578,5794
2022-01-18,50,7,415,5,245,48,302,30,12,5,1894,1544,13327,50,3505836,3234697,1323905,5844
2022-01-19,55,8,431,5,257,45,311,33,10,5,2171,1711,13941,58,3508007,3236408,1337846,5902
2022-01-20,57,7,462,8,275,50,316,31,14,4,1802,1786,14731,75,3509809,3238194,1352577,5977
2022-01-21,62,7,486,6,275,54,331,31,13,4,2439,3067,18290,107,3512248,3241261,1370867,6084
2022-01-22,62,5,493,6,289,50,330,33,13,3,2220,3260,15348,63,3514468,3244521,1386215,6147
2022-01-23,61,8,514,6,307,54,342,34,15,4,1350,2693,6639,36,3515818,3247214,1392854,6183
2022-01-24,68,7,558,6,319,59,351,33,18,3,1880,3649,12684,77,3517698,3250863,1405538,6260
2022-01-25,73,10,558,7,333,61,367,31,15,2,1651,4240,11793,70,3519349,3255103,1417331,6330
2022-01-26,73,10,583,7,345,63,382,33,13,3,1833,3689,10902,65,3521182,3258792,1428233,6395
2022-01-27,65,10,582,8,344,63,396,31,13,3,1801,3787,10574,92,3522983,3262579,1438807,6487
2022-01-28,63,10,590,8,350,57,397,32,15,2,2057,4265,12978,133,3525040,3266844,1451785,6620
2022-01-29,57,11,567,9,350,56,399,32,15,2,2069,4739,9342,71,3527109,3271583,1461127,6691
2022-01-30,63,12,572,9,369,54,400,33,12,2,999,3537,4228,35,3528108,3275120,1465355,6726
2022-01-31,65,13,587,9,400,57,415,34,14,2,1108,3479,7323,121,3529216,3278599,1472678,6847
2022-02-01,67,12,595,10,411,55,413,31,14,2,886,3131,6126,386,3530102,3281730,1478804,7233
2022-02-02,66,14,585,11,403,50,407,35,16,2,944,2830,5660,381,3531046,3284560,1484464,7614
2022-02-03,69,13,579,10,399,53,398,38,17,2,906,2889,5321,394,3531952,3287449,1489785,8008
2022-02-04,67,9,569,12,393,53,401,37,19,2,1047,3611,7915,485,3532999,3291060,1497700,8493
2022-02-05,59,9,551,11,385,51,393,35,18,4,1006,4052,5697,244,3534005,3295112,1503397,8737
2022-02-06,61,8,555,10,394,54,412,35,18,4,612,2894,2486,92,3534617,3298006,1505883,8829
2022-02-07,67,9,572,10,417,55,419,37,22,2,562,1801,4007,363,3535179,3299807,1509890,9192
2022-02-08,71,7,540,10,436,49,416,40,26,2,593,2450,3859,277,3535772,3302257,1513749,9469
2022-02-09,69,8,524,10,441,45,412,44,21,2,773,2542,5114,464,3536545,3304799,1518863,9933
2022-02-10,70,8,494,11,433,44,417,44,23,4,769,2318,4567,384,3537314,3307117,1523430,10317
2022-02-11,65,8,500,11,428,44,417,41,20,4,747,2567,5767,458,3538061,3309684,1529197,10775
2022-02-12,63,8,497,10,407,43,401,43,19,5,689,2991,4426,230,3538750,3312675,1533623,11005
2022-02-13,66,9,490,11,416,42,405,40,21,5,382,1876,1685,88,3539132,3314551,1535308,11093
2022-02-14,66,9,499,11,419,40,411,39,20,5,357,1267,2685,286,3539489,3315818,1537993,11379
2022-02-15,63,10,478,10,409,41,415,39,19,5,432,1683,2884,318,3539921,3317501,1540877,11697
2022-02-16,58,12,479,9,396,39,417,36,20,5,505,2028,2615,255,3540426,3319529,1543492,11952
2022-02-17,60,10,486,9,399,38,410,38,20,4,587,2316,2889,271,3541013,3321845,1546381,12223
2022-02-18,57,6,468,9,399,39,391,39,20,4,582,2353,3916,324,3541595,3324198,1550297,12547
2022-02-19,55,6,441,9,391,36,379,31,17,4,517,2236,2931,174,3542112,3326434,1553228,12721
2022-02-20,56,5,436,9,394,39,380,27,16,2,331,1164,1079,75,3542443,3327598,1554307,12796
2022-02-21,58,5,426,9,406,39,378,26,13,2,188,921,980,66,3542631,3328519,1555287,12862
2022-02-22,60,4,425,7,400,38,373,24,16,3,377,1345,2129,260,3543008,3329864,1557416,13122
2022-02-23,59,4,419,8,396,37,364,24,16,3,376,1465,2011,243,3543384,3331329,1559427,13365
2022-02-24,49,3,413,8,377,38,346,22,15,2,303,1119,2022,217,3543687,3332448,1561449,13582
2022-02-25,44,3,414,8,383,34,348,19,12,2,353,1533,2652,354,3544040,3333981,1564101,13936
2022-02-26,42,4,397,8,358,29,335,17,13,2,500,2176,2063,136,3544540,3336157,1566164,14072
2022-02-27,43,5,396,8,365,28,329,20,14,2,162,892,820,78,3544702,3337049,1566984,14150
2022-02-28,42,5,406,8,371,29,334,19,15,2,253,798,1720,240,3544955,3337847,1568704,14390
2022-03-01,39,5,396,8,373,25,333,20,17,2,301,891,1486,266,3545256,3338738,1570190,14656
2022-03-02,39,6,384,7,374,24,321,17,17,2,250,1006,1402,267,3545506,3339744,1571592,14923
2022-03-03,37,6,367,7,364,24,320,17,16,2,306,1106,1401,170,3545812,3340850,1572993,15093
2022-03-04,40,6,363,7,353,24,315,15,16,2,330,1548,1996,277,3546142,3342398,1574989,15370
2022-03-05,35,5,348,7,332,22,297,15,15,2,311,1495,1454,165,3546453,3343893,1576443,15535
2022-03-06,38,5,350,6,340,22,294,17,14,2,129,605,675,47,3546582,3344498,1577118,15582
2022-03-07,37,4,346,6,342,21,305,17,15,2,207,761,1127,196,3546789,3345259,1578245,15778
2022-03-08,37,4,345,6,337,19,296,19,16,2,303,802,1159,216,3547092,3346061,1579404,15994
2022-03-09,36,4,333,6,339,18,287,18,15,2,221,757,1169,241,3547313,3346818,1580573,16235
2022-03-10,36,5,329,5,330,19,287,19,15,1,244,837,1170,190,3547557,3347655,1581743,16425
2022-03-11,35,5,322,6,322,19,277,16,17,1,299,1352,1793,236,3547856,3349007,1583536,16661
2022-03-12,30,5,299,6,317,19,263,16,16,1,297,1347,1323,155,3548153,3350354,1584859,16816
2022-03-13,31,5,283,6,319,19,276,16,16,1,80,474,595,64,3548233,3350828,1585454,16880
2022-03-14,32,5,281,6,331,19,279,15,15,1,223,654,2588,235,3548456,3351482,1588042,17115
2022-03-15,32,5,278,5,325,17,278,12,15,2,268,653,2066,254,3548724,3352135,1590108,17369
2022-03-16,32,5,284,5,311,18,273,11,15,2,249,740,1967,245,3548973,3352875,1592075,17614
2022-03-17,31,5,287,5,321,18,266,8,15,2,233,722,2075,243,3549206,3353597,1594150,17857
2022-03-18,32,5,276,3,315,17,266,8,14,2,273,1110,3170,347,3549479,3354707,1597320,18204
2022-03-19,31,5,259,3,309,18,261,8,14,1,314,1161,2637,190,3549793,3355868,1599957,18394
2022-03-20,33,5,266,3,318,18,265,10,15,1,111,578,1027,56,3549904,3356446,1600984,18450
2022-03-21,38,5,270,3,325,18,270,11,15,1,188,752,1909,255,3550092,3357198,1602893,18705
2022-03-22,38,5,266,3,325,19,261,11,18,1,256,730,1589,200,3550348,3357928,1604482,18905
2022-03-23,35,5,265,3,324,18,250,12,16,1,264,816,1572,216,3550612,3358744,1606054,19121
2022-03-24,34,5,265,2,335,19,254,8,16,1,235,768,1700,257,3550847,3359512,1607754,19378
2022-03-25,33,4,266,2,333,18,251,7,16,1,272,968,2292,284,3551119,3360480,1610046,19662
2022-03-26,34,4,271,2,327,18,232,5,14,1,278,1210,1910,134,3551397,3361690,1611956,19796
2022-03-27,33,4,269,2,342,18,240,7,13,1,120,504,787,62,3551517,3362194,1612743,19858
2022-03-28,37,6,279,2,360,19,257,9,13,1,192,673,1623,230,3551709,3362867,1614366,20088
2022-03-29,41,5,265,2,366,18,252,10,14,1,204,749,1456,210,3551913,3363616,1615822,20298
2022-03-30,42,5,261,2,369,17,251,11,11,1,281,901,1564,281,3552194,3364517,1617386,20579
2022-03-31,40,5,254,2,369,14,250,8,10,1,241,881,1818,305,3552435,3365398,1619204,20884
2022-04-01,38,5,248,2,367,13,243,7,9,1,261,877,2229,388,3552696,3366275,1621433,21272
2022-04-02,38,5,242,2,366,13,236,7,9,1,256,710,1453,230,3552952,3366985,1622886,21502
2022-04-03,35,5,250,2,396,14,238,8,7,1,122,346,606,62,3553074,3367331,1623492,21564
2022-04-04,37,5,262,2,423,14,244,8,7,1,201,397,1316,318,3553275,3367728,1624808,21882
2022-04-05,34,5,273,3,434,14,243,7,9,1,209,394,1316,299,3553484,3368122,1626124,22181
2022-04-06,37,4,268,3,440,14,242,8,11,1,263,520,1411,429,3553747,3368642,1627535,22610
2022-04-07,36,4,261,3,451,14,242,11,11,0,214,540,1608,804,3553961,3369182,1629143,23414
2022-04-08,35,4,257,3,460,17,241,13,10,0,284,755,2045,889,3554245,3369937,1631188,24303
2022-04-09,33,4,255,3,456,17,232,13,9,0,279,714,1666,538,3554524,3370651,1632854,24841
2022-04-10,33,3,266,2,476,17,234,11,10,0,90,296,665,125,3554614,3370947,1633519,24966
2022-04-11,36,3,269,2,486,16,241,11,10,0,204,384,1417,1213,3554818,3371331,1634936,26179
2022-04-12,34,3,266,2,494,16,247,13,8,0,203,502,1471,8095,3555021,3371833,1636407,34274
2022-04-13,33,2,271,2,486,15,243,13,10,0,293,517,1601,6659,3555314,3372350,1638008,40933
2022-04-14,37,2,270,2,494,15,237,13,11,0,373,695,2271,7003,3555687,3373045,1640279,47936
2022-04-15,36,2,271,2,492,15,229,12,13,0,191,440,1139,1590,3555878,3373485,1641418,49526
2022-04-16,33,2,262,2,508,15,228,11,16,0,285,443,1333,1984,3556163,3373928,1642751,51510
2022-04-17,34,3,273,3,527,16,244,9,15,0,142,195,476,483,3556305,3374123,1643227,51993
2022-04-18,33,3,280,3,552,16,254,11,17,0,258,466,1496,3993,3556563,3374589,1644723,55986
2022-04-19,33,3,289,3,554,16,253,14,19,0,281,582,1247,4473,3556844,3375171,1645970,60459
2022-04-20,35,3,296,3,560,15,241,17,19,0,258,506,1219,4207,3557102,3375677,1647189,64666
2022-04-21,37,3,288,3,576,17,247,15,17,0,273,462,1354,4936,3557375,3376139,1648543,69602
2022-04-22,38,2,288,3,585,17,258,13,17,0,344,540,1544,4720,3557719,3376679,1650087,74322
2022-04-23,36,3,290,2,571,16,248,12,18,0,271,513,1181,1740,3557990,3377192,1651268,76062
2022-04-24,37,3,302,2,594,17,245,13,15,0,172,209,532,457,3558162,3377401,1651800,76519
2022-04-25,38,3,321,2,614,17,247,12,21,0,238,296,1213,4377,3558400,3377697,1653013,80896
2022-04-26,37,3,315,2,618,19,252,12,22,0,189,287,1109,4129,3558589,3377984,1654122,85025
2022-04-27,37,3,308,2,615,18,257,15,19,0,253,360,1044,4503,3558842,3378344,1655166,89528
2022-04-28,38,3,308,2,604,16,246,14,16,0,239,370,1081,4235,3559081,3378714,1656247,93763
2022-04-29,34,3,315,2,596,17,241,13,15,0,319,548,1369,3489,3559400,3379262,1657616,97252
2022-04-30,32,4,300,1,580,16,241,12,14,0,305,405,878,1135,3559705,3379667,1658494,98387
2022-05-01,32,4,311,1,605,16,254,11,15,0,175,167,444,309,3559880,3379834,1658938,98696
2022-05-02,33,4,323,1,638,17,263,10,18,0,201,285,939,3230,3560081,3380119,1659877,101926
2022-05-03,34,5,327,2,640,16,259,9,23,0,249,251,899,3592,3560330,3380370,1660776,105518
2022-05-04,36,5,321,2,620,17,249,8,21,0,265,274,937,3733,3560595,3380644,1661713,109251
2022-05-05,34,5,313,1,625,16,252,8,18,0,223,384,904,3659,3560818,3381028,1662617,112910
2022-05-06,35,5,312,1,617,17,234,6,20,0,342,421,1046,3338,3561160,3381449,1663663,116248
2022-05-07,35,5,308,1,592,16,218,6,19,0,252,378,710,1282,3561412,3381827,1664373,117530
2022-05-08,37,5,313,1,605,15,226,8,16,0,112,165,283,381,3561524,3381992,1664656,117911
2022-05-09,39,5,317,1,622,15,232,8,18,0,236,250,775,4063,3561760,3382242,1665431,121974
2022-05-10,36,4,302,0,625,15,235,8,20,0,245,281,763,4053,3562005,3382523,1666194,126027
2022-05-11,33,5,296,0,620,15,225,6,17,0,278,338,855,4148,3562283,3382861,1667049,130175
2022-05-12,30,5,294,0,617,15,219,6,19,0,247,270,913,4135,3562530,3383131,1667962,134310
2022-05-13,32,4,281,0,603,14,220,8,21,0,289,367,885,3413,3562819,3383498,1668847,137723
2022-05-14,30,4,261,0,605,13,215,9,20,0,301,396,605,1126,3563120,3383894,1669452,138849
2022-05-15,30,4,269,0,611,13,211,10,19,1,102,132,329,591,3563222,3384026,1669781,139440
2022-05-16,30,4,276,2,624,13,214,11,18,1,208,227,698,3024,3563430,3384253,1670479,142464
2022-05-17,34,4,276,1,628,12,216,11,16,1,233,297,709,3075,3563663,3384550,1671188,145539
2022-05-18,33,4,278,1,604,12,210,10,17,1,179,312,625,3424,3563842,3384862,1671813,148963
2022-05-19,33,3,275,1,602,10,206,12,14,1,216,311,802,3326,3564058,3385173,1672615,152289
2022-05-20,33,3,256,1,560,11,193,14,12,0,318,436,940,2712,3564376,3385609,1673555,155001
2022-05-21,31,3,254,1,548,11,183,12,10,0,197,290,527,957,3564573,3385899,1674082,155958
2022-05-22,31,3,256,1,549,13,180,10,12,0,93,166,270,357,3564666,3386065,1674352,156315
2022-05-23,34,3,257,1,559,14,180,9,12,0,79,151,269,420,3564745,3386216,1674621,156735
2022-05-24,36,3,258,1,566,14,187,9,13,0,211,326,628,2783,3564956,3386542,1675249,159518
2022-05-25,34,3,251,1,559,13,182,7,12,0,274,296,635,2714,3565230,3386838,1675884,162232
2022-05-26,29,3,238,1,537,12,176,9,14,0,237,262,689,2725,3565467,3387100,1676573,164957
2022-05-27,26,3,230,0,515,12,177,8,17,0,252,363,846,2193,3565719,3387463,1677419,167150
2022-05-28,23,3,216,0,498,11,172,8,14,0,214,287,613,776,3565933,3387750,1678032,167926
2022-05-29,23,3,213,0,494,12,169,9,14,0,107,169,289,339,3566040,3387919,1678321,168265
2022-05-30,22,3,215,0,496,12,168,8,15,0,180,236,748,1906,3566220,3388155,1679069,170171
2022-05-31,23,3,217,0,494,11,161,7,14,0,197,271,668,1796,3566417,3388426,1679737,171967
2022-06-01,21,3,220,0,461,11,154,8,14,0,206,290,645,1580,3566623,3388716,1680382,173547
2022-06-02,21,2,214,1,448,9,144,9,14,0,220,267,637,1665,3566843,3388983,1681019,175212
2022-06-03,20,2,217,1,440,9,144,8,14,0,211,375,763,1548,3567054,3389358,1681782,176760
2022-06-04,22,2,213,1,418,8,135,7,13,0,181,298,612,666,3567235,3389656,1682394,177426
2022-06-05,22,2,215,1,418,8,135,5,15,0,83,154,315,217,3567318,3389810,1682709,177643
2022-06-06,27,2,219,1,428,9,134,3,14,0,180,252,558,1298,3567498,3390062,1683267,178941
2022-06-07,24,2,215,1,422,8,130,1,13,0,233,264,585,1367,3567731,3390326,1683852,180308
2022-06-08,21,2,207,1,411,8,122,1,13,0,187,304,569,1460,3567918,3390630,1684421,181768
2022-06-09,21,2,199,1,400,7,122,1,12,0,197,270,549,1321,3568115,3390900,1684970,183089
2022-06-10,19,2,198,1,389,7,125,2,13,0,158,286,513,1073,3568273,3391186,1685483,184162
2022-06-11,19,2,184,0,378,7,124,4,15,0,173,307,446,473,3568446,3391493,1685929,184635
2022-06-12,18,2,183,0,369,7,127,4,14,0,89,114,194,161,3568535,3391607,1686123,184796
2022-06-13,17,2,184,0,368,7,122,3,11,0,138,283,479,1115,3568673,3391890,1686602,185911
